12
1,5,5,5,5,7,7,5,5,5,5,6
3,5,5,5,5,13,12,3,5,5,5,12
9,5,5,5,5,5,6,9,5,5,5,6
3,5,5,5,5,5,12,3,5,5,5,12
9,5,5,5,5,5,4,9,5,5,5,6
3,5,5,5,4,3,7,5,5,5,5,12
9,5,5,5,4,9,12,1,5,5,5,6
3,5,5,5,5,5,5,5,5,5,5,12
9,5,5,5,5,5,5,5,5,5,5,6
3,5,5,5,5,5,5,5,5,5,5,12
9,5,5,5,5,5,5,5,5,5,5,6
1,5,5,5,5,5,5,5,5,5,5,12
